11111111111111111111
1R0111000000011111Q1
11011111111111111101
11000000000111000101
11111111110111010101
11100000100111010101
11101110001111010101
11101111111111010101
11100000000000010001
11111111111111111111